%%%%%%%%%%%%%%%%%%%%
%P       .        .%
% %%%%G%%%%%%%%%G% %
% %%%%%%%          %
%         %%%%%%%  %
%                  %
%%%%%%%%%%%%%%%%%%%%
