%%%%%%%%%%%%%%%%%%%%%
%                   %
%                   %
%                   %
%                   %
%         .         %
%                   %
%                   %
%                   %
%P                  %
%%%%%%%%%%%%%%%%%%%%%