%%%%%%%%%%%%%%%%%%%%
%P                .%
% %%%%G%%%%%%%%%G% %
% %%%%%%%          %
%         %%%%%%%  %
%                  %
%%%%%%%%%%%%%%%%%%%%
