%%%%%%%%%%%%%%%%%%%%
% P           %    %
% %% %% %% %% %% % %
%                % %
%%%%%%%%%%%%%%%%%% %
%.                 %
%%%%%%%%%%%%%%%%%%%%
