%%%%%%%%%%%%%%%%%%%%%%%%%%%%%%%%%%%%%
%.                                 .%
%            %                      %
%            %                      %
%            %                      %
%            %                      %
%            %                      %
%            %      %               %
%            %      %               %
%            %      %               %
%            %      %               %
%            %      %               %
%            %      %               %
%           P%      %               %
%%%%%%%%%%%%%%      %%%%%%%%%%%%%%%%%
%            %                      %
%            %                      %
%            %                      %
%                                   %
%                                   %
%                                   %
%.                                 .%
%%%%%%%%%%%%%%%%%%%%%%%%%%%%%%%%%%%%%