%%%%%
%.P.%
%%% %
%. .%
%%%%%
