%%%%%%%%%%%%%%%%%%%%%
%.                 .%
%                   %
%                   %
%                   %
%         P         %
%                   %
%                   %
%                   %
%.                 .%
%%%%%%%%%%%%%%%%%%%%%