%%%%%%%%%%%%%%%%%%%%
%.             %  .%
% %% %% %% %% %% % %
%        P       % %
%%%%%%%%%%%%%%%%%% %
%.                .%
%%%%%%%%%%%%%%%%%%%%
