%%%%%%%%%%%%%%
%. . . . . % %
%          % %
%. . . . . % %
%          % %
%. . . . . % %
%          % %
%. . . . . % %
%     P    % %
%. . . . . % %
%          % %
%. . . . . % %
%          % %
%%%%%%%%%%%%%%
