%%%%%%%%%
%.P    G% 
% %.% %%%
%G    %%% 
%%%%%%%%%
