%%%%%%%%%%%%%%%%%%%%%%%%%%%%%%%%%%%%
%.................................P%
%.%%%%%%%%%%%%%%%%%%%%%%%.%%%%%%%%.%
%o%%...%...%......%%%%%%%...%%....o%
%.%%.%.%.%.%.%%%%.%%%%%%%%%.%%.%%%%%
%.%%.%.%.%.%.............%% %%.....%
%.%%.%.%.%.%.% %%%%..%%%....%%%%%%.%
%.%..%.%.%...%....%% %%%%%%%%......%
%.%%.%.%.%%%%%%%% %% GG     %%.%%%%%
%.%%.%...%% GG    %%%%%%%%%.%%.....%
%....%%%%%%.%%%%%%%......%%.%%%%%%.%
%%%%%%......%.......%%%% %%.%......%
%......%%%%%% %%%%% %    %%.%%.%%%%%
%.%%%%%%......%.......%%%%%.%%.....%
%o.......%%%%%%.%%%%%%%%%%%.%%..%%o%
%%%%%%%%%%..................%%%%%%.%
%..........%%%%%%%%%%%%%%%%........%
%%%%%%%%%%%%%%%%%%%%%%%%%%%%%%%%%%%%